NO ./textures/test/north.xpm
SO ./textures/test/south.xpm
WE ./textures/test/west.xpm
EA ./textures/test/east.xpm

F 180,238,200
C 250,204,204

111111111111111
100000000000001
101111111101111
101000000000001
101011111111101
100000000000101
111111111110101
1S0000000000001
111111111111111