NO ./textures/chris_no.xpm
SO ./textures/chris_so.xpm
WE ./textures/chris_we.xpm
EA ./textures/chris_ea.xpm

F 34,139,34
C 25,25,112

1111111111
1000000001
1011111101
1000000001
1011111101
1001E00001
1011111101
1000000001
1111111111