NO ./textures/sweet_no.xpm
SO ./textures/sweet_so.xpm
WE ./textures/sweet_we.xpm
EA ./textures/sweet_ea.xpm

F 220,100,0
C 135,206,250

1111111111
1000000001
1011111101
1000N00001
1011111101
1001000001
1011111101
1000000001
1111111111
